Bunnie	|1 year(s), Long,  Brown-with-Cream,  Siberian,  Active,  Female
Darwin	|3 year(s), Short,  Black,  Unknown,  Dominant,  Male
Mittens	|5 year(s), Short,  Black-with-White-Paws,  Siamese,  Timid,  Male
Robin	|8 year(s), Short,  White,  Birman,  Shy,  Female
KittyKitty	|7 year(s), Short,  Black,  Unknown,  Timid,  Male
Bulldozer	|14 week(s), Long,  Orange,  Munchkin,  Shy,  Male
Meowmix	|6 year(s),  N/A,  N/A,  Sphynx,  Timid,  Male
MeowMan	|16 week(s),  Short,  Blue-Gray,  Russian Shorthair,  Dominant,  Male
Artemis	|2 year(s),  Long,  White,  Siberian,  Active,  Female
Gertrude	|5 year(s),  Long,  Black,  Siberian,  Timid,  Female
Meowzer	|4 year(s),  Short,  Gray,  Munchkin,  Timid,  Female
Melbourne	|3 year(s),  Short,  White,  Persian,  Timid,  Female
News	|13 year(s),  Long,  Gray,  Maine Coon,  Dominant,  Male
Kittypie	|17 week(s),  Long,  Black,  Ragdoll,  Active,  Female
Seventeen	|6 year(s),  Long,  Cream,  Abyssinian,  Dominant,  Male
Norton	|2 year(s),  N/A,  N/A,  Sphynx,  Dominant,  Male
Meowington	|27 week(s),  Long,  White,  Ragdoll,  Timid,  Male
Isabel	|2 year(s),  Long,  White-and-Brown,  Siamese,  Dominant,  Female
Pepper	|17 week(s),  Long,  Black,  Maine Coon,  Active,  Male
Rambo	|29 week(s),  Short,  Orange-and-White,  Tabby,  Timid,  Male
Marine	|6 year(s),  Long,  Blue-Gray,  Russian Bluehair,  Active,  Female
Melonhead	|18 week(s),  Short,  Black,  Ragdoll,  Timid,  Male