Bunnie	|1 year(s), Long,  Brown-with-Cream,  Siberian,  Active,  Female,  bunniesdrinklattes@gmail.com
Darwin	|3 year(s), Short,  Black,  Unknown,  Dominant,  Male,  ndnd@gmail.com
Mittens	|5 year(s), Short,  Black-with-White-Paws,  Siamese,  Timid,  Male,  ilovedogs48@gmail.com
Robin	|8 year(s), Short,  White,  Birman,  Shy,  Female,  lisarox0123@gmail.com
KittyKitty	|7 year(s), Short,  Black,  Unknown,  Timid,  Male,  ndstil@gmail.com
Bulldozer	|14 week(s), Long,  Orange,  Munchkin,  Shy,  Male,  awesomecoolguy13@gmail.com
Meowmix	|6 year(s),  N/A, N/A,  Sphynx,  Timid,  Male,  iloveyahoo@gmail.com
MeowMan	|16 week(s),  Short,  Blue-Gray,  Russian Shorthair,  Dominant,  Male,  gamingpro134@gmail.com
Artemis	|2 year(s),  Long,  White,  Siberian,  Active,  Female,  paintingislife017@gmail.com
Gertrude	|5 year(s),  Long,  Black,  Siberian,  Timid,  Female,  reeooma9328@gmail.com
Meowzer	|4 year(s),  Short,  Gray,  Munchkin,  Timid,  Female,  definitelynotacat@gmail.com
Melbourne	|3 year(s),  Short,  White,  Persian,  Timid,  Female,  polymer1843@gmail.com
News	|13 year(s),  Long,  Gray,  Maine Coon,  Dominant,  Male,  nylon30210@gmail.com
Kittypie	|17 week(s),  Long,  Black,  Ragdoll,  Active,  Female,  kittycatlover1013232@gmail.com
Seventeen	|6 year(s),  Long,  Cream,  Abyssinian,  Dominant,  Male,  mcdonalds@gmail.com
Norton	|2 year(s),  N/A,  N/A,  Sphynx,  Dominant,  Male,  meowzillaaaa@gmail.com
Meowington	|27 week(s),  Long,  White,  Ragdoll,  Timid,  Male,  meatballsub231@gmail.com
Isabel	|2 year(s),  Long,  White-and-Brown,  Siamese,  Dominant,  Female,  migumirox1032@gmail.com
Pepper	|17 week(s),  Long,  Black,  Maine Coon,  Active,  Male,  lancecarroll@gmail.com
Rambo	|29 week(s),  Short,  Orange-and-White,  Tabby,  Timid,  Male,  ExampleMail@gmail.com
Marine	|6 year(s),  Long,  Blue-Gray,  Russian Bluehair,  Active,  Female,  ExampleEmail1@gmail.com
Melonhead	|18 week(s),  Short,  Black,  Ragdoll,  Timid,  Male,  lolcats132@gmail.com
